O...............
................
................
AAA.............
.......AAAA.....
................
................
...AAAA.....AAAA
................
................
................
...........AAAAA
................
................
................
.....AAAAAAA....
................
................
................
AAA....AAAA.....
................
P...............
................
AAAAA...........
