...............................................................................................................................................................................................................*.*..............
........................................................*.......................................................................................................................................................................
.........................................................................................................................................................................................................................*......
................................................................................................................................................*.*.....*.*.*.*.*.*..........................................*..........*.*.....
...................................**.**.................*.................................*...................................................AAAAA...AAAAAAAAAAAA*...................................AAA...A..................
...................................AA.AA...........*.*.....................................A.............................................*.........................A*...........................................................
...................................................AAA..................................................*................................AA.........................A*.....................................*......*****.........
.............................................*.*.......................................................AAA.........................*........*........................A*....................................A......AAAAA.........
...............................**...........AAAAA.......................................*..................*.......................AA.......A.........................A*...................................................*....
...............................AA.........................*.............................A...................................*.........*................................A*....................**..........*......................
............................................................................................................................AAA.......A.................................A*...................AA..........A......................
................................................................................................AAAAA...........................*........................................A*.....................*...............................
...........................*........................................................*................A..........................A.........................................A*.............*......A......*.............AA.........
..........................BAA..............................*.....*..*...*...........AA................A.....*.....*.....*..................................................A*............AA.......*....A........................
.........................................................AAAAAAA.A..A...A..............................A.........AAA...AAA..................................................A*....................A.........................*...
........................................................................................................A....................................................................A*......*..............*...........................
.............*.....*................AAAAA....................................*..*........................A....*.................................................AAA...........A......AA.............AA..........AAA.............
............AAA...AAA...AAAAA....................AAAAAA......................AAAAA........................AAAAA.................................................................................................................
........*..............................................................................................................................................................AA........*..............................................
.......AAA....................AAAAA.......AAAA...........................................................................................................AAAAA..................AAA....................AAAAAAA..................
......................................................................AAAAAA....................................................................................................................................................
P...............................................................................................................................................................................................................................
.............................................................................................................................................................................................................................***
BAAAAAAAAAAAAAAABAAAAAAAAAAAAAAABAAAAAAAAAAAAAAABAAAAAAAAAAAAAAABAAAAAAAAAAAAAAABAAAAAAAAAAAAAAABAAAAAAAAAAAAAAABAAAAAAAAAAAAAAABAAAAAAAAAAAAAAABAAAAAAAAAAAAAAABAAAAAAAAAAAAAAABAAAAAAAAAAAAAAABAAAAAAAAAAAAAAABAAAAAAAAAAAAAAA
